############
# P        #
#      O   #
#          #
#          #
#####      #
#          #
#  O       #
#      XX  #
#      #   #
############
