############
# P        #
#     OO   #
#          #
#          #
#####  X   #
#          #
#  O       #
#      XX  #
#      #   #
############
